Path, Type, Name, Line, SLOC, LLOC, Params, Cyclomatic Complexity, Cyclomatic Density, Halstead Operators Distinct, Halstead Operators Total, Halstead Operands Distinct, Halstead Operands Total, Halstead Vocabulary, Halstead Length, Halstead Volume, Halstead Difficulty, Halstead Effort, Halstead Time, Halstead Bugs
test/bootstrap.js, control, program, 5, 368, 116, 48, 33, 0.28448275862068967, 23, 294, 141, 420, 164, 714, 5253.292131297312, 34.25531914893617, 179953.1985401845, 9997.399918899138, 1.751097377099104
test/bootstrap.js, control, makeEventUid, 68, 3, 1, 2, 3, 3, 5, 6, 3, 6, 8, 12, 36, 5, 180, 10, 0.012
test/bootstrap.js, control, getElementEvents, 72, 8, 4, 1, 2, 0.5, 7, 12, 6, 14, 13, 26, 96.21143267166839, 8.166666666666668, 785.7267001519587, 43.65148334177548, 0.032070477557222796
test/bootstrap.js, control, bootstrapHandler, 81, 11, 1, 2, 1, 1, 2, 2, 3, 3, 5, 5, 11.60964047443681, 1, 11.60964047443681, 0.6449800263576005, 0.0038698801581456034
test/bootstrap.js, control, handler, 82, 9, 5, 1, 2, 0.4, 7, 12, 12, 19, 19, 31, 131.68575291675114, 5.541666666666666, 729.7585474136625, 40.542141522981254, 0.04389525097225038
test/bootstrap.js, control, bootstrapDelegationHandler, 93, 25, 1, 3, 1, 1, 2, 2, 4, 4, 6, 6, 15.509775004326936, 1, 15.509775004326936, 0.861654166907052, 0.005169925001442312
test/bootstrap.js, control, handler, 94, 23, 3, 1, 2, 0.6666666666666665, 8, 11, 8, 12, 16, 23, 92, 6, 552, 30.666666666666668, 0.030666666666666665
test/bootstrap.js, control, findHandler, 119, 7, 1, 3, 1, 1, 3, 5, 6, 7, 9, 12, 38.03910001730775, 1.75, 66.56842503028857, 3.6982458350160314, 0.012679700005769252
test/bootstrap.js, control, normalizeParameters, 127, 14, 6, 3, 4, 0.6666666666666665, 13, 18, 11, 23, 24, 41, 187.98346252956745, 13.59090909090909, 2554.8661498336664, 141.93700832409257, 0.06266115417652249
test/bootstrap.js, control, addHandler, 142, 65, 20, 5, 9, 0.45, 15, 58, 30, 78, 45, 136, 746.8920211008358, 19.5, 14564.394411466297, 809.1330228592387, 0.24896400703361193
test/bootstrap.js, control, removeHandler, 208, 16, 5, 5, 2, 0.4, 8, 14, 10, 22, 18, 36, 150.11730005192322, 8.8, 1321.0322404569245, 73.3906800253847, 0.05003910001730774
test/bootstrap.js, control, removeNamespacedHandlers, 225, 15, 1, 4, 2, 2, 5, 5, 6, 8, 11, 13, 44.97261104228487, 3.333333333333333, 149.90870347428287, 8.328261304126826, 0.01499087034742829
test/bootstrap.js, control, getTypeEvent, 241, 5, 2, 1, 2, 1, 5, 6, 5, 9, 10, 15, 49.82892142331044, 4.5, 224.23014640489697, 12.45723035582761, 0.016609640474436815
test/bootstrap.js, control, on, 248, 3, 1, 4, 1, 1, 1, 1, 6, 10, 7, 11, 30.880904142633646, 0.8333333333333334, 25.73408678552804, 1.429671488084891, 0.010293634714211216
test/bootstrap.js, control, one, 252, 3, 1, 4, 1, 1, 1, 1, 6, 10, 7, 11, 30.880904142633646, 0.8333333333333334, 25.73408678552804, 1.429671488084891, 0.010293634714211216
test/bootstrap.js, control, off, 256, 56, 13, 4, 8, 0.6153846153846154, 12, 37, 23, 40, 35, 77, 394.9547923047624, 10.434782608695652, 4121.267397962738, 228.95929988681877, 0.1316515974349208
test/bootstrap.js, control, trigger, 313, 42, 25, 3, 7, 0.28, 15, 61, 27, 66, 42, 127, 684.8243126929026, 18.333333333333336, 12555.112399369882, 697.5062444094378, 0.2282747708976342
test/bootstrap.js, control, hydrateObj, 357, 16, 1, 2, 1, 1, 1, 1, 2, 3, 3, 4, 6.339850002884624, 0.75, 4.754887502163468, 0.26416041678685936, 0.002113283334294875
test/mocha.js, control, program, 1, 267, 126, 8, 14, 0.1111111111111111, 22, 412, 128, 476, 150, 888, 6419.190997160342, 40.90625, 262585.03172759025, 14588.057318199459, 2.1397303323867805
test/mocha.js, control, NyanCat, 34, 40, 16, 2, 1, 0.0625, 9, 51, 30, 66, 39, 117, 618.3920596068831, 9.9, 6122.081390108143, 340.1156327837857, 0.2061306865356277
test/mocha.js, control, <anonymous>, 49, 4, 2, 0, 1, 0.5, 2, 5, 5, 5, 7, 10, 28.07354922057604, 1, 28.07354922057604, 1.5596416233653356, 0.009357849740192013
test/mocha.js, control, <anonymous>, 54, 3, 1, 0, 1, 1, 2, 2, 2, 2, 4, 4, 8, 1, 8, 0.4444444444444444, 0.0026666666666666666
test/mocha.js, control, <anonymous>, 58, 3, 1, 0, 1, 1, 2, 2, 2, 2, 4, 4, 8, 1, 8, 0.4444444444444444, 0.0026666666666666666
test/mocha.js, control, <anonymous>, 62, 3, 1, 0, 1, 1, 2, 2, 2, 2, 4, 4, 8, 1, 8, 0.4444444444444444, 0.0026666666666666666
test/mocha.js, control, <anonymous>, 66, 7, 5, 0, 2, 0.4, 7, 14, 12, 15, 19, 29, 123.18989788986397, 4.375, 538.9558032681549, 29.94198907045305, 0.04106329929662132
test/mocha.js, control, <anonymous>.draw, 86, 7, 5, 0, 1, 0.2, 4, 12, 6, 12, 10, 24, 79.72627427729671, 4, 318.90509710918684, 17.71694983939927, 0.026575424759098902
test/mocha.js, control, <anonymous>.drawScoreboard, 101, 16, 7, 0, 1, 0.14285714285714285, 5, 16, 15, 24, 20, 40, 172.8771237954945, 4, 691.508495181978, 38.417138621221, 0.0576257079318315
test/mocha.js, control, draw, 104, 5, 3, 2, 1, 0.33333333333333326, 2, 11, 9, 17, 11, 28, 96.86408532184434, 1.8888888888888888, 182.9654944968171, 10.164749694267616, 0.032288028440614784
test/mocha.js, control, <anonymous>.appendRainbow, 124, 12, 8, 0, 4, 0.5, 10, 26, 16, 28, 26, 54, 253.823744779619, 8.75, 2220.957766821666, 123.38654260120367, 0.08460791492653967
test/mocha.js, control, <anonymous>.drawRainbow, 143, 11, 3, 0, 1, 0.33333333333333326, 5, 9, 7, 10, 12, 19, 68.11428751370197, 3.5714285714285716, 243.2653125489356, 13.514739586051979, 0.022704762504567322
test/mocha.js, control, <anonymous>, 146, 5, 3, 1, 1, 0.33333333333333326, 3, 14, 11, 18, 14, 32, 121.83535750584335, 2.4545454545454546, 299.0504229688882, 16.613912387160454, 0.04061178583528111
test/mocha.js, control, <anonymous>.drawNyanCat, 160, 28, 21, 0, 5, 0.23809523809523805, 6, 76, 33, 95, 39, 171, 903.8037794254445, 8.636363636363637, 7805.57809503793, 433.64322750210727, 0.30126792647514816
test/mocha.js, control, <anonymous>.face, 196, 11, 10, 0, 4, 0.4, 6, 15, 9, 13, 15, 28, 109.39293667703852, 4.333333333333333, 474.03605893383354, 26.335336607435195, 0.03646431222567951
test/mocha.js, control, <anonymous>.cursorUp, 215, 3, 1, 1, 1, 1, 3, 5, 6, 7, 9, 12, 38.03910001730775, 1.75, 66.56842503028857, 3.6982458350160314, 0.012679700005769252
test/mocha.js, control, <anonymous>.cursorDown, 226, 3, 1, 1, 1, 1, 3, 5, 6, 7, 9, 12, 38.03910001730775, 1.75, 66.56842503028857, 3.6982458350160314, 0.012679700005769252
test/mocha.js, control, <anonymous>.generateColors, 236, 14, 10, 0, 2, 0.2, 12, 55, 22, 55, 34, 110, 559.6209125375374, 15, 8394.31368806306, 466.35076044794783, 0.18654030417917913
test/mocha.js, control, <anonymous>.rainbowify, 258, 8, 5, 1, 2, 0.4, 9, 19, 12, 20, 21, 39, 171.30037948837168, 7.5, 1284.7528461627876, 71.37515812015486, 0.05710012649612389
test/mui.js, control, program, 1, 1248, 142, 10, 33, 0.2323943661971831, 31, 379, 147, 389, 178, 768, 5741.363274982194, 41.01700680272109, 235493.53650683767, 13082.97425037987, 1.913787758327398
test/mui.js, control, stripDiacritics, 4, 3, 1, 1, 1, 1, 3, 5, 6, 7, 9, 12, 38.03910001730775, 1.75, 66.56842503028857, 3.6982458350160314, 0.012679700005769252
test/mui.js, control, createFilterOptions, 8, 40, 2, 1, 1, 0.5, 3, 3, 1, 2, 4, 5, 10, 3, 30, 1.6666666666666667, 0.0033333333333333335
test/mui.js, control, getInputValue, 59, 7, 4, 3, 4, 1, 10, 11, 7, 14, 17, 25, 102.1865710312585, 10, 1021.865710312585, 56.77031723958805, 0.03406219034375283
test/mui.js, control, useAutocomplete, 67, 1182, 101, 1, 11, 0.10891089108910892, 21, 252, 115, 267, 136, 519, 3678.3932146089264, 24.378260869565217, 89672.829366575, 4981.823853698611, 1.2261310715363087
test/mui.js, control, validOptionIndex, 273, 40, 14, 2, 11, 0.7857142857142857, 20, 52, 22, 50, 42, 102, 550.0163771234336, 22.72727272727273, 12500.372207350765, 694.4651226305981, 0.18333879237447787
test/mui.js, control, validTagIndex, 731, 31, 11, 2, 10, 0.9090909090909091, 16, 42, 18, 37, 34, 79, 401.90956445877686, 16.444444444444443, 6609.179504433218, 367.1766391351788, 0.13396985481959228
test/p5.js, control, program, 78, 3972, 719, 87, 166, 0.23087621696801114, 37, 2199, 435, 2540, 472, 4739, 42094.845410925765, 108.02298850574714, 4547211.001975637, 252622.83344309093, 14.031615136975255
test/p5.js, control, <anonymous>.select, 78, 10, 7, 2, 2, 0.2857142857142857, 7, 16, 13, 19, 20, 35, 151.26748332105768, 5.115384615384615, 773.7913569884873, 42.98840872158263, 0.05042249444035256
test/p5.js, control, <anonymous>.selectAll, 172, 13, 10, 2, 3, 0.3, 11, 28, 19, 32, 30, 60, 294.41343573651113, 9.263157894736842, 2727.1981415592613, 151.5110078644034, 0.09813781191217037
test/p5.js, control, <anonymous>._getContainer, 189, 11, 10, 1, 5, 0.5, 11, 20, 9, 21, 20, 41, 177.19905189038187, 12.833333333333334, 2274.0544992599007, 126.33636106999448, 0.05906635063012729
test/p5.js, control, <anonymous>._wrapElement, 204, 31, 16, 1, 7, 0.4375, 14, 63, 27, 64, 41, 127, 680.4091045864966, 16.59259259259259, 11289.75106869446, 627.2083927052478, 0.22680303486216552
test/p5.js, control, converted.checked, 208, 10, 8, 1, 3, 0.375, 6, 17, 8, 17, 14, 34, 129.45006734995854, 6.375, 825.2441793559857, 45.84689885311032, 0.04315002244998618
test/p5.js, control, <anonymous>, 225, 3, 1, 1, 2, 2, 4, 6, 4, 7, 8, 13, 39, 3.5, 136.5, 7.583333333333333, 0.013
test/p5.js, control, <anonymous>.removeElements, 302, 7, 4, 1, 1, 0.25, 4, 11, 11, 13, 15, 24, 93.76537429460444, 2.3636363636363638, 221.6272483327014, 12.312624907372301, 0.03125512476486815
test/p5.js, control, <anonymous>.changed, 380, 4, 2, 1, 1, 0.5, 3, 4, 6, 8, 9, 12, 38.03910001730775, 2, 76.0782000346155, 4.226566668589751, 0.012679700005769252
test/p5.js, control, <anonymous>.input, 453, 4, 2, 1, 1, 0.5, 3, 4, 6, 8, 9, 12, 38.03910001730775, 2, 76.0782000346155, 4.226566668589751, 0.012679700005769252
test/p5.js, control, addElement, 461, 7, 5, 3, 3, 0.6, 7, 19, 14, 28, 21, 47, 206.43891887060175, 7, 1445.0724320942122, 80.28180178301179, 0.06881297295686725
test/p5.js, control, <anonymous>.createDiv, 515, 5, 3, 1, 1, 0.33333333333333326, 5, 8, 8, 11, 13, 19, 70.30835464468075, 3.4375, 241.68496909109007, 13.426942727282782, 0.02343611821489358
test/p5.js, control, <anonymous>.createP, 550, 5, 3, 1, 1, 0.33333333333333326, 5, 8, 8, 11, 13, 19, 70.30835464468075, 3.4375, 241.68496909109007, 13.426942727282782, 0.02343611821489358
test/p5.js, control, <anonymous>.createSpan, 621, 5, 3, 1, 1, 0.33333333333333326, 5, 8, 8, 11, 13, 19, 70.30835464468075, 3.4375, 241.68496909109007, 13.426942727282782, 0.02343611821489358
test/p5.js, control, <anonymous>.createImg, 680, 21, 12, 0, 3, 0.25, 12, 38, 23, 44, 35, 82, 420.60120738948723, 11.478260869565219, 4827.770380470636, 268.20946558170203, 0.1402004024631624
test/p5.js, control, <anonymous>, 693, 6, 5, 0, 4, 0.8, 9, 19, 11, 21, 20, 40, 172.8771237954945, 8.590909090909092, 1485.1716544249302, 82.50953635694057, 0.0576257079318315
test/p5.js, control, <anonymous>.createA, 756, 8, 7, 3, 2, 0.2857142857142857, 6, 15, 14, 24, 20, 39, 168.55519570060713, 5.142857142857142, 866.8552921745509, 48.1586273430306, 0.05618506523353571
test/p5.js, control, <anonymous>.createSlider, 887, 14, 13, 4, 4, 0.3076923076923077, 9, 27, 19, 38, 28, 65, 312.4780699337442, 9, 2812.302629403698, 156.2390349668721, 0.10415935664458141
test/p5.js, control, <anonymous>.createButton, 978, 7, 6, 2, 2, 0.33333333333333326, 6, 13, 13, 20, 19, 33, 140.1816079436383, 4.615384615384616, 646.9920366629461, 35.94400203683034, 0.04672720264787944
test/p5.js, control, <anonymous>.createCheckbox, 1082, 54, 18, 1, 3, 0.16666666666666663, 7, 48, 27, 58, 34, 106, 539.2710611725361, 7.518518518518519, 4054.5194599268457, 225.25108110704699, 0.17975702039084535
test/p5.js, control, self.checked, 1102, 13, 10, 1, 4, 0.4, 8, 22, 12, 22, 20, 44, 190.16483617504394, 7.333333333333333, 1394.5421319503223, 77.47456288612902, 0.06338827872501465
test/p5.js, control, <anonymous>.value, 1116, 4, 2, 1, 1, 0.5, 3, 3, 4, 5, 7, 8, 22.458839376460833, 1.875, 42.11032383086406, 2.3394624350480036, 0.007486279792153611
test/p5.js, control, <anonymous>.createSelect, 1309, 108, 21, 1, 4, 0.19047619047619047, 13, 51, 24, 60, 37, 111, 578.2493235848135, 16.25, 9396.55150825322, 522.0306393474011, 0.19274977452827116
test/p5.js, control, self.option, 1328, 32, 19, 2, 7, 0.3684210526315789, 15, 48, 21, 55, 36, 103, 532.5022751485582, 19.642857142857142, 10459.866118989536, 581.1036732771964, 0.17750075838285273
test/p5.js, control, self.selected, 1361, 21, 12, 1, 5, 0.41666666666666674, 13, 35, 14, 33, 27, 68, 323.3323501471159, 15.321428571428571, 4953.913507611169, 275.21741708950935, 0.10777745004903863
test/p5.js, control, self.disable, 1383, 13, 9, 1, 4, 0.4444444444444444, 12, 30, 12, 31, 24, 61, 279.6827125439906, 15.5, 4335.082044431854, 240.83789135732525, 0.09322757084799686
test/p5.js, control, self.enable, 1397, 17, 13, 1, 5, 0.3846153846153847, 12, 45, 11, 48, 23, 93, 420.69126191330224, 26.18181818181818, 11014.46213009373, 611.9145627829851, 0.14023042063776742
test/p5.js, control, <anonymous>.createRadio, 1578, 158, 31, 1, 8, 0.25806451612903225, 14, 75, 29, 80, 43, 155, 841.0710369788252, 19.310344827586206, 16241.371748556623, 902.2984304753679, 0.2803570123262751
test/p5.js, control, self._getOptionsArray, 1618, 9, 1, 0, 1, 1, 3, 9, 7, 7, 10, 16, 53.1508495181978, 1.5, 79.72627427729671, 4.429237459849817, 0.017716949839399268
test/p5.js, control, self.option, 1628, 45, 21, 2, 5, 0.23809523809523805, 10, 47, 29, 63, 39, 110, 581.3942440748474, 10.862068965517242, 6315.144375295757, 350.84135418309756, 0.19379808135828247
test/p5.js, control, self.remove, 1674, 14, 0, 1, 1, 0, 0, 0, 1, 1, 1, 1, 0, 0, 0, 0, 0
test/p5.js, control, self.value, 1689, 10, 2, 0, 1, 0.5, 3, 3, 2, 3, 5, 6, 13.931568569324174, 2.25, 31.34602928097939, 1.7414460711655217, 0.004643856189774725
test/p5.js, control, self.selected, 1700, 27, 5, 1, 2, 0.4, 8, 10, 7, 9, 15, 19, 74.23092131656186, 5.142857142857143, 381.7590239137467, 21.208834661874818, 0.024743640438853954
test/p5.js, control, self.disable, 1728, 5, 0, 1, 1, 0, 0, 0, 1, 1, 1, 1, 0, 0, 0, 0, 0
test/p5.js, control, <anonymous>.createColorPicker, 1801, 35, 19, 1, 3, 0.15789473684210525, 13, 47, 31, 67, 44, 114, 622.3752045246518, 14.048387096774192, 8743.367792596318, 485.7426551442399, 0.2074584015082173
test/p5.js, control, self.color, 1823, 11, 6, 0, 4, 0.6666666666666665, 5, 19, 10, 21, 15, 40, 156.27562382434076, 5.25, 820.447025077789, 45.58039028209939, 0.052091874608113584
test/p5.js, control, <anonymous>.createInput, 1912, 7, 5, 2, 1, 0.2, 5, 12, 15, 21, 20, 33, 142.62362713128297, 3.5, 499.1826949594904, 27.73237194219391, 0.04754120904376099
test/p5.js, control, <anonymous>.createFileInput, 2022, 23, 11, 2, 3, 0.2727272727272727, 9, 30, 30, 40, 39, 70, 369.9781553203574, 6, 2219.8689319221444, 123.32605177345246, 0.12332605177345247
test/p5.js, control, handleFileSelect, 2025, 5, 0, 1, 1, 0, 0, 0, 1, 1, 1, 1, 0, 0, 0, 0, 0
test/p5.js, control, createMedia, 2049, 43, 11, 4, 4, 0.36363636363636365, 10, 26, 20, 35, 30, 61, 299.32032633211963, 8.75, 2619.052855406047, 145.50293641144705, 0.09977344211070655
test/p5.js, control, <anonymous>.createVideo, 2184, 4, 2, 2, 1, 0.5, 3, 4, 9, 11, 12, 15, 53.77443751081735, 1.8333333333333335, 98.58646876983181, 5.477026042768434, 0.017924812503605784
test/p5.js, control, <anonymous>.createAudio, 2232, 4, 2, 2, 1, 0.5, 3, 4, 9, 11, 12, 15, 53.77443751081735, 1.8333333333333335, 98.58646876983181, 5.477026042768434, 0.017924812503605784
test/p5.js, control, <anonymous>.getUserMedia, 2253, 18, 4, 1, 3, 0.75, 10, 14, 10, 13, 20, 27, 116.69205856195879, 6.5, 758.4983806527321, 42.13879892515178, 0.03889735285398626
test/p5.js, control, <anonymous>, 2267, 3, 1, 2, 1, 1, 2, 2, 6, 8, 8, 10, 30, 1.3333333333333333, 40, 2.2222222222222223, 0.01
test/p5.js, control, <anonymous>.createCapture, 2393, 77, 20, 1, 2, 0.1, 14, 52, 37, 62, 51, 114, 646.6564889847506, 11.72972972972973, 7585.1058437670745, 421.3947690981708, 0.21555216299491686
test/p5.js, control, <anonymous>, 2428, 11, 7, 1, 3, 0.42857142857142855, 7, 13, 9, 16, 16, 29, 116, 6.222222222222221, 721.7777777777777, 40.09876543209876, 0.03866666666666667
test/p5.js, control, <anonymous>, 2451, 16, 12, 0, 4, 0.33333333333333326, 5, 33, 16, 39, 21, 72, 316.24685444007076, 6.09375, 1927.1292692441812, 107.06273718023229, 0.10541561814669026
test/p5.js, control, <anonymous>.createElement, 2520, 8, 5, 2, 2, 0.4, 8, 13, 13, 18, 21, 31, 136.16184010614157, 5.538461538461538, 754.1271144340149, 41.89595080188971, 0.04538728003538052
test/p5.js, control, <anonymous>.addClass, 2560, 10, 6, 1, 3, 0.5, 8, 19, 6, 20, 14, 39, 148.48684196024658, 13.333333333333334, 1979.8245594699545, 109.99025330388636, 0.04949561398674886
test/p5.js, control, <anonymous>.removeClass, 2608, 5, 2, 1, 1, 0.5, 3, 5, 5, 7, 8, 12, 36, 2.0999999999999996, 75.6, 4.199999999999999, 0.012
test/p5.js, control, <anonymous>.hasClass, 2651, 3, 1, 1, 1, 1, 3, 5, 5, 6, 8, 11, 33, 1.7999999999999998, 59.39999999999999, 3.2999999999999994, 0.011
test/p5.js, control, <anonymous>.toggleClass, 2688, 11, 5, 1, 2, 0.4, 5, 15, 7, 17, 12, 32, 114.71880002307701, 6.071428571428571, 696.5070001401103, 38.69483334111724, 0.03823960000769234
test/p5.js, control, <anonymous>.child, 2786, 18, 12, 1, 6, 0.5, 9, 30, 16, 32, 25, 62, 287.9190837660329, 9, 2591.271753894296, 143.95954188301644, 0.09597302792201096
test/p5.js, control, <anonymous>.center, 2839, 31, 28, 1, 9, 0.32142857142857145, 14, 110, 32, 112, 46, 222, 1226.230754244657, 24.5, 30042.653478994096, 1669.036304388561, 0.408743584748219
test/p5.js, control, <anonymous>.html, 2946, 11, 9, 1, 3, 0.33333333333333326, 7, 20, 9, 21, 16, 41, 164, 8.166666666666668, 1339.3333333333335, 74.40740740740742, 0.05466666666666667
test/p5.js, control, <anonymous>.position, 3016, 23, 14, 1, 8, 0.5714285714285714, 11, 57, 25, 63, 36, 120, 620.3910001730775, 13.86, 8598.619262398854, 477.70107013326964, 0.2067970000576925
test/p5.js, control, <anonymous>._translate, 3041, 23, 16, 1, 5, 0.3125, 11, 70, 25, 78, 36, 148, 765.1489002134622, 17.16, 13129.955127663012, 729.441951536834, 0.2550496334044874
test/p5.js, control, <anonymous>._rotate, 3066, 21, 16, 1, 5, 0.3125, 10, 69, 20, 77, 30, 146, 716.4060269588438, 19.25, 13790.816018957743, 766.1564454976524, 0.23880200898628126
test/p5.js, control, <anonymous>.style, 3195, 49, 23, 2, 10, 0.43478260869565216, 19, 103, 44, 105, 63, 208, 1243.2742240879827, 22.670454545454543, 28185.591784721877, 1565.8662102623266, 0.4144247413626609
test/p5.js, control, <anonymous>.attribute, 3306, 22, 13, 2, 6, 0.4615384615384615, 15, 49, 16, 50, 31, 99, 490.4654347283007, 23.4375, 11495.283626444547, 638.6268681358082, 0.1634884782427669
test/p5.js, control, <anonymous>.removeAttribute, 3366, 13, 6, 1, 4, 0.6666666666666665, 13, 31, 13, 34, 26, 65, 305.528581679171, 17, 5193.985888545907, 288.5547715858837, 0.10184286055972366
test/p5.js, control, <anonymous>.value, 3452, 10, 8, 1, 3, 0.375, 8, 21, 9, 20, 17, 41, 167.58597649126395, 8.88888888888889, 1489.6531243667907, 82.75850690926615, 0.05586199216375465
test/p5.js, control, <anonymous>.show, 3494, 4, 2, 0, 1, 0.5, 3, 5, 5, 6, 8, 11, 33, 1.7999999999999998, 59.39999999999999, 3.2999999999999994, 0.011
test/p5.js, control, <anonymous>.hide, 3527, 4, 2, 0, 1, 0.5, 3, 5, 5, 6, 8, 11, 33, 1.7999999999999998, 59.39999999999999, 3.2999999999999994, 0.011
test/p5.js, control, <anonymous>.size, 3652, 48, 39, 2, 11, 0.28205128205128205, 19, 130, 33, 153, 52, 283, 1613.2244402339293, 44.04545454545455, 71055.20375393989, 3947.511319663327, 0.5377414800779764
test/p5.js, control, <anonymous>.remove, 3731, 28, 14, 0, 6, 0.42857142857142855, 11, 48, 22, 51, 33, 99, 499.39501781648687, 12.75, 6367.286477160207, 353.7381376200115, 0.16646500593882896
test/p5.js, control, <anonymous>.drop, 3870, 44, 10, 2, 3, 0.3, 10, 30, 23, 37, 33, 67, 337.9744059970164, 8.043478260869566, 2718.4897873673062, 151.02721040929478, 0.1126581353323388
test/p5.js, control, preventDefault, 3876, 3, 1, 1, 1, 1, 2, 2, 2, 3, 4, 5, 10, 1.5, 15, 0.8333333333333334, 0.0033333333333333335
test/p5.js, control, <anonymous>, 3892, 14, 4, 1, 2, 0.5, 7, 11, 8, 13, 15, 24, 93.76537429460444, 5.6875, 533.2905663005628, 29.6272536833646, 0.03125512476486815
test/p5.js, control, <anonymous>.draggable, 3983, 67, 22, 1, 6, 0.2727272727272727, 13, 40, 30, 58, 43, 98, 531.7739459608056, 12.566666666666666, 6682.625920907457, 371.25699560596985, 0.17725798198693518
test/p5.js, control, dragMouseDown, 4006, 16, 11, 1, 3, 0.2727272727272727, 8, 27, 19, 38, 27, 65, 309.0676876406255, 8, 2472.541501125004, 137.3634167291669, 0.10302256254687515
test/p5.js, control, elementDrag, 4023, 19, 14, 1, 3, 0.21428571428571427, 9, 52, 21, 63, 30, 115, 564.2924184949796, 13.5, 7617.947649682225, 423.21931387123476, 0.18809747283165987
test/p5.js, control, closeDragElement, 4043, 4, 2, 0, 1, 0.5, 2, 4, 7, 10, 9, 14, 44.37895002019238, 1.4285714285714286, 63.39850002884626, 3.522138890491459, 0.014792983340064125
test/swagger.js, control, program, 1, 897, 317, 43, 103, 0.3249211356466877, 27, 857, 265, 838, 292, 1695, 13881.75262730163, 42.69056603773585, 592619.8772553334, 32923.32651418519, 4.62725087576721
test/swagger.js, control, objectify, 7, 5, 3, 1, 2, 0.6666666666666665, 5, 7, 4, 6, 9, 13, 41.20902501875006, 3.75, 154.53384382031274, 8.58521354557293, 0.013736341672916687
test/swagger.js, control, arrayify, 13, 7, 5, 1, 3, 0.6, 6, 11, 4, 9, 10, 20, 66.43856189774725, 6.75, 448.46029280979394, 24.91446071165522, 0.02214618729924908
test/swagger.js, control, fromJSOrdered, 21, 20, 12, 1, 6, 0.5, 8, 37, 17, 36, 25, 73, 339.0015018535549, 8.470588235294118, 2871.542133347759, 159.53011851931993, 0.11300050061785163
test/swagger.js, control, createObjWithHashedKeys, 60, 33, 6, 1, 2, 0.33333333333333326, 8, 14, 8, 12, 16, 26, 104, 6, 624, 34.666666666666664, 0.034666666666666665
test/swagger.js, control, bindToState, 94, 7, 3, 2, 1, 0.33333333333333326, 6, 10, 8, 10, 14, 20, 76.1470984411521, 3.75, 285.55161915432035, 15.863978841906686, 0.025382366147050698
test/swagger.js, control, normalizeArray, 102, 4, 3, 1, 2, 0.6666666666666665, 5, 6, 4, 7, 9, 13, 41.20902501875006, 4.375, 180.2894844570315, 10.016082469835084, 0.013736341672916687
test/swagger.js, control, isFn, 107, 3, 1, 1, 1, 1, 3, 3, 2, 3, 5, 6, 13.931568569324174, 2.25, 31.34602928097939, 1.7414460711655217, 0.004643856189774725
test/swagger.js, control, isObject, 111, 3, 1, 1, 1, 1, 5, 6, 2, 4, 7, 10, 28.07354922057604, 5, 140.3677461028802, 7.798208116826678, 0.009357849740192013
test/swagger.js, control, isFunc, 115, 3, 1, 1, 1, 1, 3, 3, 2, 3, 5, 6, 13.931568569324174, 2.25, 31.34602928097939, 1.7414460711655217, 0.004643856189774725
test/swagger.js, control, isArray, 119, 3, 1, 1, 1, 1, 3, 3, 3, 4, 6, 7, 18.094737505048094, 2, 36.18947501009619, 2.0105263894497885, 0.006031579168349364
test/swagger.js, control, objMap, 126, 6, 1, 2, 1, 1, 4, 6, 6, 7, 10, 13, 43.18506523353572, 2.3333333333333335, 100.76515221158334, 5.59806401175463, 0.014395021744511906
test/swagger.js, control, objReduce, 133, 7, 1, 2, 1, 1, 4, 6, 6, 7, 10, 13, 43.18506523353572, 2.3333333333333335, 100.76515221158334, 5.59806401175463, 0.014395021744511906
test/swagger.js, control, systemThunkMiddleware, 142, 12, 1, 1, 1, 1, 1, 1, 1, 1, 2, 2, 2, 0.5, 1, 0.05555555555555555, 0.0006666666666666666
test/swagger.js, control, defaultStatusCode, 155, 9, 2, 1, 2, 1, 6, 14, 8, 12, 14, 26, 98.99122797349771, 4.5, 445.46052588073974, 24.74780699337443, 0.03299707599116591
test/swagger.js, control, getList, 171, 7, 4, 2, 4, 1, 9, 23, 12, 24, 21, 47, 206.43891887060175, 9, 1857.9502698354158, 103.21945943530088, 0.06881297295686725
test/swagger.js, control, mapToList, 186, 32, 9, 3, 5, 0.5555555555555556, 10, 31, 17, 30, 27, 61, 290.0481376319716, 8.823529411764707, 2559.248273223279, 142.1804596235155, 0.09668271254399054
test/swagger.js, control, extractFileNameFromContentDispositionHeader, 219, 24, 9, 1, 3, 0.33333333333333326, 11, 18, 16, 23, 27, 41, 194.95038758870223, 7.90625, 1541.326501873177, 85.62925010406539, 0.06498346252956741
test/swagger.js, control, pascalCase, 245, 3, 1, 1, 1, 1, 2, 3, 3, 4, 5, 7, 16.253496664211536, 1.3333333333333333, 21.67132888561538, 1.2039627158675212, 0.005417832221403845
test/swagger.js, control, pascalCaseFilename, 250, 3, 1, 1, 1, 1, 3, 4, 5, 6, 8, 10, 30, 1.7999999999999998, 53.99999999999999, 2.9999999999999996, 0.01
test/swagger.js, control, validateValueBySchema, 407, 221, 135, 5, 57, 0.4222222222222222, 19, 372, 107, 379, 126, 751, 5239.937222548438, 33.649532710280376, 176321.43896995936, 9795.635498331076, 1.746645740849479
test/swagger.js, control, requiresValidationURL, 704, 11, 3, 1, 5, 1.666666666666667, 8, 14, 8, 14, 16, 28, 112, 7, 784, 43.55555555555556, 0.037333333333333336
test/swagger.js, control, getAcceptControllingResponse, 716, 28, 9, 1, 7, 0.7777777777777779, 9, 38, 17, 33, 26, 71, 333.7312199880176, 8.735294117647058, 2915.2403628365064, 161.95779793536147, 0.11124373999600586
test/swagger.js, control, deeplyStripKey, 770, 22, 5, 3, 5, 1, 12, 21, 13, 22, 25, 43, 199.68581616031315, 10.153846153846153, 2027.5790563970259, 112.64328091094588, 0.06656193872010438
test/swagger.js, control, stringify, 793, 23, 12, 1, 7, 0.5833333333333334, 11, 29, 13, 29, 24, 58, 265.9278250418271, 12.26923076923077, 3262.729853397802, 181.2627696332112, 0.08864260834727569
test/swagger.js, control, numberToString, 817, 7, 3, 1, 2, 0.6666666666666665, 6, 7, 3, 6, 9, 13, 41.20902501875006, 6, 247.25415011250038, 13.736341672916687, 0.013736341672916687
test/swagger.js, control, paramToIdentifier, 825, 32, 11, 2, 6, 0.5454545454545454, 14, 36, 19, 37, 33, 73, 368.2407707131671, 13.631578947368421, 5019.70313761633, 278.8723965342406, 0.1227469235710557
test/swagger.js, control, paramToValue, 858, 13, 4, 2, 1, 0.25, 7, 13, 11, 14, 18, 27, 112.58797503894243, 4.454545454545454, 501.52825244619805, 27.86268069145545, 0.03752932501298081
test/swagger.js, control, generateCodeVerifier, 873, 3, 1, 0, 1, 1, 3, 5, 5, 5, 8, 10, 30, 1.5, 45, 2.5, 0.01
test/swagger.js, control, createCodeChallenge, 877, 5, 1, 1, 1, 1, 3, 7, 7, 8, 10, 15, 49.82892142331044, 1.7142857142857142, 85.42100815424646, 4.745611564124804, 0.016609640474436815
test/swagger.js, control, b64toB64UrlEncoded, 883, 3, 1, 1, 1, 1, 3, 7, 8, 11, 11, 18, 62.26976913547136, 2.0625, 128.43139884190967, 7.135077713439426, 0.020756589711823786
test/bootstrap.js, test, program, 5, 368, 63, 15, 18, 0.2857142857142857, 20, 265, 118, 226, 138, 491, 3490.285508278081, 19.152542372881356, 66847.84109074969, 3713.768949486094, 1.1634285027593603
test/bootstrap.js, test, makeEventUid, 68, 3, 1, 2, 3, 3, 9, 11, 8, 17, 17, 28, 114.4489595550095, 9.5625, 1094.4181757447782, 60.801009763598785, 0.038149653185003164
test/bootstrap.js, test, getElementEvents, 72, 8, 4, 1, 2, 0.5, 9, 14, 6, 14, 15, 28, 109.39293667703852, 10.5, 1148.6258351089045, 63.81254639493914, 0.03646431222567951
test/bootstrap.js, test, bootstrapHandler, 81, 11, 1, 2, 1, 1, 4, 4, 3, 3, 7, 7, 19.651484454403228, 2, 39.302968908806456, 2.1834982727114696, 0.00655049481813441
test/bootstrap.js, test, handler, 82, 9, 4, 1, 2, 0.5, 9, 19, 11, 18, 20, 37, 159.91133951083242, 7.363636363636364, 1177.5289545797662, 65.41827525443145, 0.05330377983694414
test/bootstrap.js, test, bootstrapDelegationHandler, 93, 25, 1, 3, 1, 1, 4, 5, 4, 4, 8, 9, 27, 2, 54, 3, 0.009
test/bootstrap.js, test, handler, 94, 23, 9, 1, 5, 0.5555555555555556, 17, 43, 18, 35, 35, 78, 400.08407532170736, 16.52777777777778, 6612.500689344886, 367.36114940804924, 0.13336135844056912
test/bootstrap.js, test, findHandler, 119, 7, 1, 4, 1, 1, 10, 18, 9, 16, 19, 34, 144.4295354570819, 8.88888888888889, 1283.8180929518392, 71.32322738621329, 0.048143178485693966
test/bootstrap.js, test, normalizeParameters, 127, 14, 6, 3, 4, 0.6666666666666666, 17, 27, 11, 23, 28, 50, 240.36774610288018, 17.772727272727273, 4271.990396646644, 237.33279981370242, 0.08012258203429339
test/bootstrap.js, test, addHandler, 142, 65, 20, 5, 9, 0.45, 19, 86, 30, 81, 49, 167, 937.6565439672398, 25.650000000000002, 24050.890352759703, 1336.1605751533168, 0.3125521813224133
test/bootstrap.js, test, wrapFunction, 162, 11, 1, 1, 1, 1, 3, 3, 1, 1, 4, 4, 8, 1.5, 12, 0.6666666666666666, 0.0026666666666666666
test/bootstrap.js, test, anonymous, 163, 9, 2, 1, 3, 1.5, 11, 22, 7, 16, 18, 38, 158.45715005480787, 12.571428571428571, 1992.032743546156, 110.66848575256422, 0.05281905001826929
test/bootstrap.js, test, removeHandler, 208, 16, 5, 5, 2, 0.4, 12, 25, 11, 23, 23, 48, 217.13097389073664, 12.545454545454545, 2724.006763356514, 151.3337090753619, 0.07237699129691222
test/bootstrap.js, test, removeNamespacedHandlers, 225, 15, 4, 4, 4, 1, 12, 29, 14, 24, 26, 53, 249.12330506147785, 10.285714285714285, 2562.4111377752006, 142.35617432084447, 0.08304110168715928
test/bootstrap.js, test, getTypeEvent, 241, 5, 2, 1, 2, 1, 9, 9, 6, 10, 15, 19, 74.23092131656186, 7.5, 556.731909874214, 30.929550548567445, 0.024743640438853954
test/bootstrap.js, test, hydrateObj, 357, 16, 6, 2, 3, 0.5, 14, 30, 12, 21, 26, 51, 239.72242562519568, 12.25, 2936.599713908647, 163.1444285504804, 0.07990747520839857
test/mocha.js, test, program, 1, 267, 23, 0, 1, 0.043478260869565216, 5, 63, 29, 67, 34, 130, 661.3701693625441, 5.775862068965517, 3819.9828747664183, 212.22127082035658, 0.22045672312084802
test/mocha.js, test, NyanCat, 34, 40, 16, 2, 1, 0.0625, 10, 60, 31, 58, 41, 118, 632.1911365449339, 9.354838709677418, 5914.0461160655095, 328.55811755919495, 0.2107303788483113
test/mocha.js, test, anonymous, 49, 4, 2, 0, 1, 0.5, 4, 7, 5, 5, 9, 12, 38.03910001730775, 2, 76.0782000346155, 4.226566668589751, 0.012679700005769252
test/mocha.js, test, anonymous, 54, 3, 1, 0, 1, 1, 4, 4, 2, 2, 6, 6, 15.509775004326936, 2, 31.019550008653873, 1.723308333814104, 0.005169925001442312
test/mocha.js, test, anonymous, 58, 3, 1, 0, 1, 1, 4, 4, 2, 2, 6, 6, 15.509775004326936, 2, 31.019550008653873, 1.723308333814104, 0.005169925001442312
test/mocha.js, test, anonymous, 62, 3, 1, 0, 1, 1, 4, 4, 2, 2, 6, 6, 15.509775004326936, 2, 31.019550008653873, 1.723308333814104, 0.005169925001442312
test/mocha.js, test, anonymous, 66, 7, 4, 0, 2, 0.5, 9, 17, 12, 15, 21, 32, 140.55415752892034, 5.625, 790.6171361001769, 43.923174227787605, 0.04685138584297345
test/mocha.js, test, NyanCat.prototype.draw, 86, 7, 5, 0, 1, 0.2, 6, 14, 6, 12, 12, 26, 93.20902501875005, 6, 559.2541501125004, 31.069675006250023, 0.03106967500625002
test/mocha.js, test, NyanCat.prototype.drawScoreboard, 101, 16, 7, 0, 1, 0.14285714285714285, 7, 20, 15, 23, 22, 43, 191.75555960140377, 5.366666666666667, 1029.088169860867, 57.17156499227039, 0.0639185198671346
test/mocha.js, test, draw, 104, 5, 3, 2, 1, 0.3333333333333333, 5, 15, 10, 18, 15, 33, 128.92738965508113, 4.5, 580.1732534478651, 32.23184741377028, 0.04297579655169371
test/mocha.js, test, NyanCat.prototype.appendRainbow, 124, 12, 7, 0, 4, 0.5714285714285714, 14, 31, 16, 28, 30, 59, 289.50654514090263, 12.25, 3546.4551779760573, 197.02528766533652, 0.09650218171363421
test/mocha.js, test, NyanCat.prototype.drawRainbow, 143, 11, 3, 0, 1, 0.3333333333333333, 6, 10, 6, 9, 12, 19, 68.11428751370197, 4.5, 306.51429381165883, 17.028571878425492, 0.022704762504567322
test/mocha.js, test, anonymous, 146, 5, 3, 1, 1, 0.3333333333333333, 5, 16, 11, 18, 16, 34, 136, 4.090909090909091, 556.3636363636364, 30.90909090909091, 0.04533333333333334
test/mocha.js, test, NyanCat.prototype.drawNyanCat, 160, 28, 21, 0, 5, 0.23809523809523808, 10, 82, 33, 95, 43, 177, 960.4488615822713, 14.393939393939394, 13824.6427045933, 768.0357058107388, 0.3201496205274238
test/mocha.js, test, NyanCat.prototype.face, 196, 11, 10, 0, 4, 0.4, 8, 20, 9, 13, 17, 33, 134.88627376126118, 5.777777777777778, 779.3429150650646, 43.29682861472581, 0.04496209125375373
test/mocha.js, test, NyanCat.prototype.cursorUp, 215, 3, 1, 1, 1, 1, 5, 7, 6, 7, 11, 14, 48.432042660922164, 2.916666666666667, 141.26012442768965, 7.847784690427202, 0.01614401422030739
test/mocha.js, test, NyanCat.prototype.cursorDown, 226, 3, 1, 1, 1, 1, 5, 7, 6, 7, 11, 14, 48.432042660922164, 2.916666666666667, 141.26012442768965, 7.847784690427202, 0.01614401422030739
test/mocha.js, test, NyanCat.prototype.generateColors, 236, 14, 9, 0, 2, 0.2222222222222222, 14, 59, 21, 54, 35, 113, 579.6089809147812, 18, 10432.961656466063, 579.6089809147812, 0.1932029936382604
test/mocha.js, test, NyanCat.prototype.rainbowify, 258, 8, 5, 1, 2, 0.4, 12, 22, 12, 20, 24, 42, 192.56842503028855, 10, 1925.6842503028856, 106.98245835016031, 0.06418947501009618
test/mui.js, test, program, 1, 1248, 9, 1, 1, 0.1111111111111111, 8, 20, 14, 17, 22, 37, 164.99896988958, 4.857142857142857, 801.4235680351028, 44.52353155750571, 0.05499965662986
test/mui.js, test, stripDiacritics, 4, 3, 1, 1, 1, 1, 6, 8, 7, 8, 13, 16, 59.207035490257475, 3.4285714285714284, 202.99555025231132, 11.277530569572852, 0.019735678496752493
test/mui.js, test, createFilterOptions, 8, 40, 2, 1, 1, 0.5, 6, 18, 11, 13, 17, 31, 126.71134807876051, 3.545454545454546, 449.2493250065146, 24.958295833695257, 0.042237116026253504
test/mui.js, test, anonymous, 18, 29, 7, 2, 6, 0.8571428571428571, 15, 36, 15, 28, 30, 64, 314.0409981189452, 14, 4396.573973665233, 244.2541096480685, 0.10468033270631506
test/mui.js, test, filteredOptions, 29, 13, 6, 1, 5, 0.8333333333333334, 12, 25, 13, 21, 25, 46, 213.6173847296373, 9.692307692307693, 2070.4454212257156, 115.02474562365086, 0.0712057949098791
test/mui.js, test, getInputValue, 59, 7, 4, 3, 4, 1, 14, 18, 8, 15, 22, 33, 147.1612434150308, 13.125, 1931.4913198222794, 107.30507332345996, 0.04905374780501027
test/mui.js, test, useAutocomplete, 67, 1182, 66, 9, 16, 0.24242424242424243, 23, 534, 185, 453, 208, 987, 7600.334001805258, 28.15945945945946, 214021.29720218643, 11890.072066788134, 2.5334446672684194
test/mui.js, test, getOptionLabel, 114, 18, 7, 1, 4, 0.5714285714285714, 13, 30, 48, 113, 61, 143, 848.0954392714928, 15.302083333333332, 12977.62708635232, 720.9792825751289, 0.2826984797571642
test/mui.js, test, resetInputValue, 164, 21, 9, 3, 5, 0.5555555555555556, 16, 35, 15, 27, 31, 62, 307.16017124398627, 14.4, 4423.106465913403, 245.72813699518903, 0.10238672374799543
test/mui.js, test, filteredOptions, 212, 12, 3, 2, 3, 1, 12, 19, 10, 14, 22, 33, 147.1612434150308, 8.399999999999999, 1236.1544446862586, 68.67524692701437, 0.04905374780501027
test/mui.js, test, anonymous, 240, 14, 6, 0, 3, 0.5, 12, 20, 8, 12, 20, 32, 138.3016990363956, 9, 1244.7152913275604, 69.1508495181978, 0.0461005663454652
test/mui.js, test, focusTag, 257, 7, 4, 1, 2, 0.5, 8, 16, 23, 33, 31, 49, 242.75561920895686, 5.739130434782608, 1393.206162416622, 77.400342356479, 0.08091853973631895
test/mui.js, test, anonymous, 266, 6, 3, 0, 2, 0.6666666666666666, 8, 12, 7, 9, 15, 21, 82.0447025077789, 5.142857142857143, 421.9441843257201, 23.441343573651114, 0.02734823416925963
test/mui.js, test, validOptionIndex, 273, 40, 14, 2, 11, 0.7857142857142857, 23, 67, 40, 78, 63, 145, 866.7055889074879, 22.425, 19435.872831250417, 1079.7707128472455, 0.28890186296916265
test/mui.js, test, setHighlightedIndex, 314, 87, 36, 1, 16, 0.4444444444444444, 23, 153, 69, 255, 92, 408, 2661.6132780712614, 42.5, 113118.56431802861, 6284.364684334923, 0.8872044260237538
test/mui.js, test, changeHighlightedIndex, 403, 72, 14, 1, 5, 0.35714285714285715, 18, 66, 26, 51, 44, 117, 638.7534993805638, 17.653846153846153, 11276.456008295338, 626.4697782386298, 0.21291783312685458
test/mui.js, test, getNextIndex, 408, 46, 21, 0, 12, 0.5714285714285714, 16, 70, 17, 48, 33, 118, 595.2385060842975, 22.58823529411765, 13445.387431551191, 746.9659684195107, 0.19841283536143248
test/mui.js, test, getPreviousHighlightedOptionIndex, 477, 32, 6, 2, 4, 0.6666666666666666, 16, 57, 16, 43, 32, 100, 500, 21.5, 10750, 597.2222222222222, 0.16666666666666666
test/mui.js, test, isSameValue, 478, 5, 3, 2, 3, 1, 10, 16, 6, 14, 16, 30, 120, 11.666666666666668, 1400.0000000000002, 77.77777777777779, 0.04
test/mui.js, test, anonymous, 500, 5, 1, 1, 1, 1, 5, 8, 3, 5, 8, 13, 39, 4.166666666666667, 162.5, 9.027777777777779, 0.013
test/mui.js, test, syncHighlightedIndex, 510, 61, 26, 2, 11, 0.4230769230769231, 22, 96, 25, 67, 47, 163, 905.397982823455, 29.48, 26691.132533635453, 1482.8406963130808, 0.3017993276078183
test/mui.js, test, handleListboxRef, 584, 9, 4, 1, 2, 0.5, 7, 9, 4, 6, 11, 15, 51.89147427955946, 5.25, 272.43023996768716, 15.135013331538175, 0.017297158093186486
test/mui.js, test, anonymous, 596, 25, 5, 0, 5, 1, 15, 44, 55, 502, 70, 546, 3346.5885272519517, 68.45454545454545, 229089.19645642905, 12727.177580912725, 1.1155295090839839
test/mui.js, test, handleOpen, 627, 12, 6, 1, 3, 0.5, 5, 10, 6, 9, 11, 19, 65.72920075410865, 3.75, 246.48450282790742, 13.693583490439302, 0.02190973358470288
test/mui.js, test, handleClose, 640, 11, 5, 2, 3, 0.6, 7, 12, 6, 9, 13, 21, 77.70923408096293, 5.25, 407.97347892505536, 22.665193273614186, 0.025903078026987644
test/mui.js, test, handleValue, 652, 18, 9, 6, 5, 0.5555555555555556, 11, 35, 12, 26, 23, 61, 275.9372793194778, 11.916666666666666, 3288.25257855711, 182.68069880872835, 0.0919790931064926
test/mui.js, test, selectNewValue, 673, 57, 21, 6, 12, 0.5714285714285714, 20, 112, 84, 258, 104, 370, 2479.162695712204, 30.714285714285715, 76145.71136830341, 4230.317298239079, 0.8263875652374013
test/mui.js, test, validTagIndex, 731, 31, 11, 2, 10, 0.9090909090909091, 20, 60, 35, 62, 55, 122, 705.3258850500085, 17.714285714285715, 12494.344249457296, 694.1302360809609, 0.23510862835000285
test/mui.js, test, handleFocusTag, 763, 32, 17, 2, 8, 0.47058823529411764, 18, 54, 18, 42, 36, 96, 496.31280013846197, 21, 10422.568802907701, 579.0316001615389, 0.165437600046154
test/mui.js, test, handleClear, 796, 10, 5, 1, 3, 0.6, 10, 16, 11, 16, 21, 32, 140.55415752892034, 7.272727272727273, 1022.2120547557844, 56.789558597543575, 0.04685138584297345
test/mui.js, test, handleKeyDown, 807, 176, 74, 1, 32, 0.43243243243243246, 24, 298, 73, 233, 97, 531, 3504.553719201365, 38.3013698630137, 134229.20820393172, 7457.178233551762, 1.1681845730671216
test/mui.js, test, handleFocus, 984, 7, 3, 1, 2, 0.6666666666666666, 7, 9, 7, 8, 14, 17, 64.72503367497927, 4, 258.9001346999171, 14.383340816662061, 0.02157501122499309
test/mui.js, test, handleBlur, 992, 25, 15, 1, 5, 0.3333333333333333, 13, 46, 26, 42, 39, 88, 465.1153952598779, 10.5, 4883.711650228718, 271.31731390159547, 0.15503846508662597
test/mui.js, test, handleInputChange, 1018, 20, 11, 1, 5, 0.45454545454545453, 13, 32, 17, 26, 30, 58, 284.5996545452941, 9.941176470588236, 2829.2553893032177, 157.18085496128987, 0.09486655151509803
test/mui.js, test, handleOptionMouseMove, 1039, 10, 3, 1, 2, 0.6666666666666666, 10, 19, 11, 15, 21, 34, 149.33879237447786, 6.8181818181818175, 1018.2190389168944, 56.56772438427191, 0.04977959745815929
test/mui.js, test, handleOptionTouchStart, 1050, 8, 2, 1, 1, 0.5, 7, 15, 12, 14, 19, 29, 123.18989788986397, 4.083333333333334, 503.0254163836113, 27.945856465756183, 0.04106329929662132
test/mui.js, test, handleOptionClick, 1059, 6, 3, 1, 1, 0.3333333333333333, 8, 14, 12, 15, 20, 29, 125.33591475173351, 5, 626.6795737586675, 34.815531875481526, 0.041778638250577836
test/mui.js, test, handleTagDelete, 1066, 7, 3, 1, 1, 0.3333333333333333, 9, 17, 10, 15, 19, 32, 135.93368043019473, 6.75, 917.5523429038144, 50.97513016132302, 0.04531122681006491
test/mui.js, test, handlePopupIndicator, 1074, 7, 4, 1, 2, 0.5, 6, 9, 5, 7, 11, 16, 55.35090589819676, 4.199999999999999, 232.47380477242635, 12.915211376245908, 0.018450301966065584
test/mui.js, test, handleMouseDown, 1083, 9, 4, 1, 3, 0.75, 8, 19, 8, 13, 16, 32, 128, 6.5, 832, 46.22222222222222, 0.042666666666666665
test/mui.js, test, handleClick, 1094, 17, 6, 1, 3, 0.5, 11, 30, 14, 25, 25, 55, 255.41209043760983, 9.821428571428571, 2508.5116025122393, 139.3617556951244, 0.08513736347920328
test/mui.js, test, handleInputMouseDown, 1112, 5, 2, 1, 3, 1.5, 8, 12, 6, 7, 14, 19, 72.33974351909448, 4.666666666666667, 337.5854697557743, 18.754748319765238, 0.024113247839698163
test/mui.js, test, groupedOptions, 1127, 27, 11, 3, 4, 0.36363636363636365, 18, 56, 55, 143, 73, 199, 1231.7750872171234, 23.400000000000002, 28823.537040880692, 1601.3076133822606, 0.41059169573904114
test/mui.js, test, anonymous, 1217, 19, 3, 2, 4, 1.3333333333333333, 15, 49, 35, 53, 50, 102, 575.6733313570219, 11.357142857142858, 6538.004263269035, 363.22245907050194, 0.1918911104523406
test/p5.js, test, program, 78, 3972, 53, 0, 3, 0.05660377358490566, 6, 179, 57, 176, 63, 355, 2121.9343728424706, 9.263157894736842, 19655.8131379092, 1091.9896187727334, 0.7073114576141568
test/p5.js, test, p5.prototype.select, 78, 10, 7, 2, 2, 0.2857142857142857, 10, 22, 13, 19, 23, 41, 185.46604019833754, 7.3076923076923075, 1355.3287552955435, 75.29604196086353, 0.061822013399445847
test/p5.js, test, p5.prototype.selectAll, 172, 13, 9, 2, 3, 0.3333333333333333, 14, 34, 18, 31, 32, 65, 325, 12.055555555555557, 3918.055555555556, 217.66975308641977, 0.10833333333333334
test/p5.js, test, p5.prototype._getContainer, 189, 11, 10, 1, 5, 0.5, 13, 26, 9, 21, 22, 47, 209.59328607595296, 15.166666666666668, 3178.831505485287, 176.60175030473818, 0.06986442869198432
test/p5.js, test, p5.prototype._wrapElement, 204, 31, 16, 1, 7, 0.4375, 16, 86, 26, 62, 42, 148, 798.0629785712566, 19.076923076923077, 15224.586052743973, 845.8103362635541, 0.2660209928570855
test/p5.js, test, converted.checked, 208, 10, 8, 1, 3, 0.375, 10, 24, 8, 18, 18, 42, 175.1368500605771, 11.25, 1970.2895631814924, 109.46053128786069, 0.05837895002019237
test/p5.js, test, anonymous, 225, 3, 1, 1, 2, 2, 6, 10, 4, 7, 10, 17, 56.47277761308516, 5.25, 296.48208246869706, 16.471226803816503, 0.018824259204361718
test/p5.js, test, p5.prototype.removeElements, 302, 7, 4, 3, 1, 0.25, 10, 22, 15, 20, 25, 42, 195.04195997053841, 6.666666666666666, 1300.2797331369227, 72.23776295205126, 0.06501398665684614
test/p5.js, test, p5.Element.prototype.changed, 380, 4, 2, 1, 1, 0.5, 6, 8, 6, 8, 12, 16, 57.3594000115385, 4, 229.437600046154, 12.746533335897444, 0.019119800003846166
test/p5.js, test, p5.Element.prototype.input, 453, 4, 2, 1, 1, 0.5, 6, 8, 6, 8, 12, 16, 57.3594000115385, 4, 229.437600046154, 12.746533335897444, 0.019119800003846166
test/p5.js, test, addElement, 461, 7, 5, 3, 3, 0.6, 11, 29, 15, 29, 26, 58, 272.62550365218334, 10.633333333333333, 2898.917855501549, 161.05099197230828, 0.09087516788406111
test/p5.js, test, p5.prototype.createDiv, 515, 5, 3, 1, 1, 0.3333333333333333, 8, 12, 9, 12, 17, 24, 98.09910819000814, 5.333333333333333, 523.1952436800434, 29.06640242666908, 0.032699702730002715
test/p5.js, test, p5.prototype.createP, 550, 5, 3, 1, 1, 0.3333333333333333, 8, 12, 9, 12, 17, 24, 98.09910819000814, 5.333333333333333, 523.1952436800434, 29.06640242666908, 0.032699702730002715
test/p5.js, test, p5.prototype.createSpan, 621, 5, 3, 1, 1, 0.3333333333333333, 8, 12, 9, 12, 17, 24, 98.09910819000814, 5.333333333333333, 523.1952436800434, 29.06640242666908, 0.032699702730002715
test/p5.js, test, p5.prototype.createImg, 680, 21, 12, 0, 3, 0.25, 15, 46, 22, 43, 37, 89, 463.64134954097653, 14.65909090909091, 6796.56069213477, 377.58670511859833, 0.15454711651365885
test/p5.js, test, anonymous, 693, 6, 5, 0, 4, 0.8, 12, 22, 11, 21, 23, 43, 194.51316411045156, 11.454545454545455, 2228.059879810627, 123.78110443392373, 0.06483772137015052
test/p5.js, test, p5.prototype.createA, 756, 8, 7, 3, 2, 0.2857142857142857, 9, 21, 14, 24, 23, 45, 203.5602880225656, 7.7142857142857135, 1570.322221888363, 87.24012343824239, 0.0678534293408552
test/p5.js, test, p5.prototype.createSlider, 887, 14, 13, 4, 4, 0.3076923076923077, 12, 38, 19, 38, 31, 76, 376.5189195894025, 12, 4518.22703507283, 251.01261305960168, 0.12550630652980083
test/p5.js, test, p5.prototype.createButton, 978, 7, 6, 2, 2, 0.3333333333333333, 9, 18, 13, 20, 22, 38, 169.4584015082173, 6.923076923076923, 1173.1735489030427, 65.17630827239127, 0.05648613383607243
test/p5.js, test, p5.prototype.createCheckbox, 1082, 54, 18, 1, 3, 0.16666666666666666, 11, 53, 26, 57, 37, 110, 573.0398702191845, 12.057692307692308, 6909.53843514286, 383.86324639682556, 0.1910132900730615
test/p5.js, test, self.checked, 1102, 13, 10, 1, 4, 0.4, 12, 30, 12, 23, 24, 53, 243.00301253822127, 11.5, 2794.5346441895445, 155.2519246771969, 0.08100100417940709
test/p5.js, test, this.value, 1116, 4, 2, 1, 1, 0.5, 5, 5, 4, 5, 9, 10, 31.699250014423125, 3.125, 99.06015629507226, 5.503342016392903, 0.010566416671474375
test/p5.js, test, p5.prototype.createSelect, 1309, 108, 21, 1, 4, 0.19047619047619047, 17, 59, 23, 57, 40, 116, 617.3436590069341, 21.065217391304348, 13004.478382124329, 722.4710212291294, 0.20578121966897803
test/p5.js, test, self.option, 1328, 32, 18, 2, 7, 0.3888888888888889, 20, 64, 21, 55, 41, 119, 637.548688549552, 26.19047619047619, 16697.703747726362, 927.6502082070201, 0.21251622951651733
test/p5.js, test, self.selected, 1361, 21, 13, 1, 6, 0.46153846153846156, 17, 54, 16, 40, 33, 94, 474.17304721969464, 21.25, 10076.177253418511, 559.7876251899173, 0.15805768240656487
test/p5.js, test, self.disable, 1383, 13, 8, 1, 4, 0.5, 15, 38, 12, 31, 27, 69, 328.0872376492793, 19.375, 6356.690229454786, 353.1494571919326, 0.10936241254975977
test/p5.js, test, self.enable, 1397, 17, 11, 1, 5, 0.45454545454545453, 15, 54, 11, 48, 26, 102, 479.44485125039137, 32.72727272727273, 15690.922404558263, 871.717911364348, 0.15981495041679714
test/p5.js, test, p5.prototype.createRadio, 1578, 158, 31, 4, 8, 0.25806451612903225, 20, 91, 47, 104, 67, 195, 1182.8873921392658, 22.127659574468087, 26174.52952818801, 1454.1405293437783, 0.3942957973797553
test/p5.js, test, self._getOptionsArray, 1618, 9, 1, 2, 3, 3, 10, 25, 10, 20, 20, 45, 194.4867642699313, 10, 1944.8676426993131, 108.04820237218406, 0.06482892142331044
test/p5.js, test, self.option, 1628, 45, 25, 2, 7, 0.28, 18, 76, 31, 71, 49, 147, 825.3623470849357, 20.612903225806452, 17013.114186686256, 945.1730103714586, 0.2751207823616452
test/p5.js, test, self.remove, 1674, 14, 7, 1, 4, 0.5714285714285714, 11, 25, 7, 15, 18, 40, 166.7970000576925, 11.785714285714285, 1965.8217863942327, 109.21232146634627, 0.05559900001923083
test/p5.js, test, self.value, 1689, 10, 6, 0, 3, 0.5, 12, 17, 7, 11, 19, 28, 118.94197037642039, 9.428571428571429, 1121.4528635491065, 62.30293686383925, 0.039647323458806796
test/p5.js, test, self.selected, 1700, 27, 14, 1, 6, 0.42857142857142855, 15, 43, 12, 31, 27, 74, 351.86167516009664, 19.375, 6817.319956226873, 378.7399975681596, 0.11728722505336554
test/p5.js, test, anonymous, 1712, 4, 2, 1, 1, 0.5, 5, 6, 5, 7, 10, 13, 43.18506523353571, 3.5, 151.14772831737497, 8.397096017631943, 0.014395021744511903
test/p5.js, test, self.disable, 1728, 5, 2, 1, 2, 1, 9, 12, 7, 9, 16, 21, 84, 5.7857142857142865, 486.00000000000006, 27.000000000000004, 0.028
test/p5.js, test, p5.prototype.createColorPicker, 1801, 35, 16, 1, 3, 0.1875, 14, 66, 30, 62, 44, 128, 698.807247185574, 14.466666666666669, 10109.411509284639, 561.6339727380355, 0.23293574906185802
test/p5.js, test, self.color, 1823, 11, 6, 0, 4, 0.6666666666666666, 7, 24, 10, 21, 17, 45, 183.93582785626526, 7.3500000000000005, 1351.9283347435498, 75.10712970797499, 0.06131194261875509
test/p5.js, test, p5.prototype.createInput, 1912, 7, 5, 2, 1, 0.2, 8, 21, 17, 23, 25, 44, 204.32967235008786, 5.411764705882353, 1105.7841091887108, 61.43245051048393, 0.06810989078336262
test/p5.js, test, p5.prototype.createFileInput, 2022, 23, 11, 2, 3, 0.2727272727272727, 11, 41, 29, 40, 40, 81, 431.07617568587636, 7.586206896551724, 3270.233056927338, 181.679614273741, 0.1436920585619588
test/p5.js, test, handleFileSelect, 2025, 5, 2, 1, 2, 1, 8, 12, 8, 10, 16, 22, 88, 5, 440, 24.444444444444443, 0.029333333333333333
test/p5.js, test, createMedia, 2049, 43, 15, 4, 5, 0.3333333333333333, 15, 52, 26, 48, 41, 100, 535.7552004618084, 13.846153846153847, 7418.148929471194, 412.11938497062187, 0.1785850668206028
test/p5.js, test, callbackHandler, 2065, 4, 2, 0, 1, 0.5, 5, 6, 5, 5, 10, 11, 36.541209043760986, 2.5, 91.35302260940247, 5.075167922744582, 0.012180403014586996
test/p5.js, test, anonymous, 2076, 13, 10, 0, 4, 0.4, 7, 37, 11, 38, 18, 75, 312.7443751081734, 12.090909090909092, 3781.363808126097, 210.0757671181165, 0.1042481250360578
test/p5.js, test, p5.prototype.createVideo, 2184, 4, 2, 2, 1, 0.5, 6, 11, 9, 11, 15, 22, 85.95159310338741, 3.666666666666667, 315.1558413790872, 17.508657854393732, 0.02865053103446247
test/p5.js, test, p5.prototype.createAudio, 2232, 4, 2, 2, 1, 0.5, 6, 11, 9, 11, 15, 22, 85.95159310338741, 3.666666666666667, 315.1558413790872, 17.508657854393732, 0.02865053103446247
test/p5.js, test, navigator.mediaDevices.getUserMedia, 2253, 18, 4, 1, 3, 0.75, 11, 18, 9, 12, 20, 30, 129.65784284662087, 7.333333333333333, 950.8241808752197, 52.82356560417887, 0.043219280948873624
test/p5.js, test, anonymous, 2267, 3, 1, 2, 1, 1, 5, 8, 6, 8, 11, 16, 55.35090589819676, 3.333333333333333, 184.50301966065584, 10.250167758925324, 0.018450301966065584
test/p5.js, test, p5.prototype.createCapture, 2393, 77, 33, 1, 8, 0.24242424242424243, 23, 109, 42, 91, 65, 200, 1204.4735626056909, 24.916666666666664, 30011.46626825846, 1667.3036815699145, 0.4014911875352303
test/p5.js, test, anonymous, 2428, 11, 6, 1, 3, 0.5, 10, 20, 9, 16, 19, 36, 152.92539048396907, 8.88888888888889, 1359.3368043019473, 75.51871135010818, 0.050975130161323025
test/p5.js, test, anonymous, 2439, 8, 5, 1, 3, 0.6, 7, 18, 11, 18, 18, 36, 150.11730005192322, 5.7272727272727275, 859.7627184791967, 47.764595471066485, 0.05003910001730774
test/p5.js, test, anonymous, 2451, 16, 12, 0, 4, 0.3333333333333333, 7, 38, 16, 39, 23, 77, 348.31427061639, 8.53125, 2971.556121196077, 165.08645117755984, 0.11610475687213
test/p5.js, test, p5.prototype.createElement, 2520, 8, 5, 2, 2, 0.4, 11, 20, 13, 18, 24, 38, 174.22857502740393, 7.615384615384615, 1326.817609824076, 73.71208943467089, 0.05807619167580131
test/p5.js, test, p5.Element.prototype.addClass, 2560, 10, 6, 1, 3, 0.5, 10, 24, 6, 20, 16, 44, 176, 16.666666666666668, 2933.3333333333335, 162.96296296296296, 0.058666666666666666
test/p5.js, test, p5.Element.prototype.removeClass, 2608, 5, 2, 1, 1, 0.5, 5, 7, 5, 7, 10, 14, 46.50699332842307, 3.5, 162.77447664948076, 9.04302648052671, 0.015502331109474358
test/p5.js, test, p5.Element.prototype.hasClass, 2651, 3, 1, 1, 1, 1, 5, 7, 5, 6, 10, 13, 43.18506523353571, 3, 129.55519570060713, 7.197510872255951, 0.014395021744511903
test/p5.js, test, p5.Element.prototype.toggleClass, 2688, 11, 5, 1, 2, 0.4, 7, 19, 7, 17, 14, 36, 137.06477719407374, 8.5, 1165.050606149627, 64.72503367497927, 0.04568825906469125
test/p5.js, test, p5.Element.prototype.child, 2786, 18, 12, 1, 6, 0.5, 12, 40, 16, 32, 28, 72, 346.1295543881475, 12, 4153.55465265777, 230.753036258765, 0.11537651812938249
test/p5.js, test, p5.Element.prototype.center, 2839, 31, 26, 1, 9, 0.34615384615384615, 16, 127, 31, 111, 47, 238, 1321.9921466992778, 28.64516129032258, 37868.6782667406, 2103.815459263367, 0.44066404889975924
test/p5.js, test, p5.Element.prototype.html, 2946, 11, 9, 1, 3, 0.3333333333333333, 12, 28, 9, 22, 21, 50, 219.61587113893805, 14.666666666666668, 3221.032776704425, 178.94626537246805, 0.07320529037964602
test/p5.js, test, p5.Element.prototype.position, 3016, 23, 12, 1, 8, 0.6666666666666666, 15, 71, 24, 63, 39, 134, 708.2438973275413, 19.6875, 13943.551728635968, 774.6417627019982, 0.23608129910918044
test/p5.js, test, p5.Element.prototype._translate, 3041, 23, 16, 1, 5, 0.3125, 16, 82, 25, 79, 41, 161, 862.5658727435115, 25.28, 21805.665262955972, 1211.4258479419984, 0.2875219575811705
test/p5.js, test, p5.Element.prototype._rotate, 3066, 21, 16, 1, 5, 0.3125, 15, 81, 20, 78, 35, 159, 815.5559996942496, 29.25, 23855.012991056803, 1325.2784995031557, 0.27185199989808323
test/p5.js, test, p5.Element.prototype.style, 3195, 49, 22, 2, 10, 0.45454545454545453, 23, 122, 44, 105, 67, 227, 1377.0022462339145, 27.443181818181817, 37789.323007442086, 2099.4068337467825, 0.4590007487446382
test/p5.js, test, p5.Element.prototype.attribute, 3306, 22, 12, 2, 6, 0.5, 19, 66, 16, 50, 35, 116, 594.9968299656161, 29.6875, 17663.96838960423, 981.331577200235, 0.1983322766552054
test/p5.js, test, p5.Element.prototype.removeAttribute, 3366, 13, 5, 1, 4, 0.8, 16, 39, 13, 34, 29, 73, 354.63261264431276, 20.923076923076923, 7420.005433788698, 412.2225240993721, 0.11821087088143759
test/p5.js, test, p5.Element.prototype.value, 3452, 10, 8, 1, 3, 0.375, 12, 28, 9, 21, 21, 49, 215.22355371615927, 14, 3013.1297520262297, 167.39609733479054, 0.07174118457205308
test/p5.js, test, p5.Element.prototype.show, 3494, 4, 2, 0, 1, 0.5, 5, 7, 5, 6, 10, 13, 43.18506523353571, 3, 129.55519570060713, 7.197510872255951, 0.014395021744511903
test/p5.js, test, p5.Element.prototype.hide, 3527, 4, 2, 0, 1, 0.5, 5, 7, 5, 6, 10, 13, 43.18506523353571, 3, 129.55519570060713, 7.197510872255951, 0.014395021744511903
test/p5.js, test, p5.Element.prototype.size, 3652, 48, 37, 2, 11, 0.2972972972972973, 23, 160, 32, 151, 55, 311, 1798.0028709061692, 54.265625, 97569.74954151758, 5420.541641195421, 0.5993342903020564
test/p5.js, test, p5.Element.prototype.remove, 3731, 28, 13, 1, 6, 0.46153846153846156, 17, 64, 23, 54, 40, 118, 627.9875151967088, 19.956521739130437, 12532.446498925627, 696.2470277180904, 0.20932917173223628
test/p5.js, test, p5.Element.prototype.drop, 3870, 44, 10, 2, 3, 0.3, 12, 38, 22, 35, 34, 73, 371.3847874112748, 9.545454545454545, 3545.036607107623, 196.9464781726457, 0.12379492913709159
test/p5.js, test, preventDefault, 3876, 3, 1, 1, 1, 1, 4, 4, 2, 3, 6, 7, 18.094737505048094, 3, 54.28421251514428, 3.0157895841746822, 0.006031579168349364
test/p5.js, test, anonymous, 3892, 14, 6, 1, 3, 0.5, 12, 24, 13, 20, 25, 44, 204.32967235008786, 9.230769230769232, 1886.1200524623496, 104.78444735901942, 0.06810989078336262
test/p5.js, test, p5.Element.prototype.draggable, 3983, 67, 15, 1, 6, 0.4, 16, 56, 28, 55, 44, 111, 605.99690966874, 15.714285714285714, 9522.808580508772, 529.0449211393762, 0.20199896988958002
test/p5.js, test, dragMouseDown, 4006, 16, 11, 1, 3, 0.2727272727272727, 12, 35, 20, 39, 32, 74, 370, 11.7, 4329, 240.5, 0.12333333333333334
test/p5.js, test, elementDrag, 4023, 19, 14, 1, 3, 0.21428571428571427, 12, 56, 22, 64, 34, 120, 610.4955409500407, 17.454545454545453, 10655.9221693098, 591.9956760727667, 0.20349851365001356
test/p5.js, test, closeDragElement, 4043, 4, 2, 0, 1, 0.5, 5, 10, 7, 11, 12, 21, 75.28421251514428, 3.9285714285714284, 295.7594063094954, 16.4310781283053, 0.025094737505048093
test/swagger.js, test, program, 1, 897, 62, 13, 4, 0.06451612903225806, 13, 133, 67, 99, 80, 232, 1466.6873180138682, 9.604477611940299, 14086.765509580959, 782.5980838656088, 0.4888957726712894
test/swagger.js, test, objectify, 7, 5, 3, 1, 2, 0.6666666666666666, 6, 9, 4, 6, 10, 15, 49.82892142331043, 4.5, 224.23014640489694, 12.457230355827608, 0.01660964047443681
test/swagger.js, test, arrayify, 13, 7, 5, 1, 3, 0.6, 8, 13, 4, 9, 12, 22, 78.86917501586544, 9, 709.822575142789, 39.43458750793272, 0.026289725005288478
test/swagger.js, test, fromJSOrdered, 21, 20, 12, 1, 6, 0.5, 10, 44, 17, 37, 27, 81, 385.14588767524094, 10.88235294117647, 4191.293483524681, 232.84963797359336, 0.12838196255841364
test/swagger.js, test, createObjWithHashedKeys, 60, 33, 18, 1, 5, 0.2777777777777778, 19, 82, 19, 88, 38, 170, 892.1476772854095, 44, 39254.49780055802, 2180.8054333643345, 0.2973825590951365
test/swagger.js, test, bindToState, 94, 7, 3, 4, 1, 0.3333333333333333, 12, 26, 12, 22, 24, 48, 220.0782000346155, 11, 2420.8602003807705, 134.49223335448724, 0.0733594000115385
test/swagger.js, test, normalizeArray, 102, 4, 3, 1, 2, 0.6666666666666666, 7, 8, 4, 7, 11, 15, 51.89147427955946, 6.125, 317.8352799623017, 17.657515553461206, 0.017297158093186486
test/swagger.js, test, isFn, 107, 3, 1, 1, 1, 1, 5, 6, 3, 4, 8, 10, 30, 3.333333333333333, 99.99999999999999, 5.5555555555555545, 0.01
test/swagger.js, test, isObject, 111, 3, 1, 1, 1, 1, 7, 9, 3, 5, 10, 14, 46.50699332842307, 5.833333333333334, 271.29079441580126, 15.071710800877847, 0.015502331109474358
test/swagger.js, test, isFunc, 115, 3, 1, 1, 1, 1, 5, 6, 3, 4, 8, 10, 30, 3.333333333333333, 99.99999999999999, 5.5555555555555545, 0.01
test/swagger.js, test, isArray, 119, 3, 1, 1, 1, 1, 5, 5, 3, 5, 8, 10, 30, 4.166666666666667, 125.00000000000001, 6.9444444444444455, 0.01
test/swagger.js, test, objMap, 126, 6, 1, 2, 1, 1, 6, 10, 6, 7, 12, 17, 60.94436251225965, 3.5, 213.30526879290878, 11.850292710717154, 0.02031478750408655
test/swagger.js, test, anonymous, 127, 4, 2, 2, 1, 0.5, 7, 9, 4, 9, 11, 18, 62.26976913547135, 7.875, 490.37443194183686, 27.243023996768713, 0.020756589711823783
test/swagger.js, test, objReduce, 133, 7, 1, 2, 1, 1, 6, 10, 6, 7, 12, 17, 60.94436251225965, 3.5, 213.30526879290878, 11.850292710717154, 0.02031478750408655
test/swagger.js, test, anonymous, 134, 5, 4, 2, 2, 0.5, 13, 17, 8, 15, 21, 32, 140.55415752892034, 12.1875, 1713.0037948837166, 95.16687749353981, 0.04685138584297345
test/swagger.js, test, systemThunkMiddleware, 142, 12, 1, 1, 1, 1, 3, 3, 2, 2, 5, 5, 11.60964047443681, 1.5, 17.414460711655217, 0.9674700395364009, 0.0038698801581456034
test/swagger.js, test, anonymous, 143, 10, 1, 2, 1, 1, 4, 6, 3, 3, 7, 9, 25.26619429851844, 2, 50.53238859703688, 2.807354922057604, 0.008422064766172813
test/swagger.js, test, anonymous, 145, 7, 3, 1, 2, 0.6666666666666666, 7, 12, 4, 7, 11, 19, 65.72920075410865, 6.125, 402.59135461891543, 22.366186367717525, 0.02190973358470288
test/swagger.js, test, defaultStatusCode, 155, 9, 2, 2, 2, 1, 13, 23, 13, 18, 26, 41, 192.71802844378476, 9, 1734.4622559940628, 96.35901422189238, 0.06423934281459492
test/swagger.js, test, getList, 171, 7, 4, 2, 4, 1, 13, 29, 12, 24, 25, 53, 246.1243780580604, 13, 3199.616914754785, 177.75649526415472, 0.0820414593526868
test/swagger.js, test, mapToList, 186, 32, 16, 3, 7, 0.4375, 16, 75, 28, 61, 44, 136, 742.4827001346724, 17.428571428571427, 12940.412773775719, 718.9118207653178, 0.24749423337822415
test/swagger.js, test, extractFileNameFromContentDispositionHeader, 219, 24, 8, 1, 3, 0.375, 15, 29, 16, 23, 31, 52, 257.6182081401175, 10.78125, 2777.4463065106415, 154.30257258392453, 0.08587273604670582
test/swagger.js, test, anonymous, 228, 4, 2, 1, 1, 0.5, 7, 8, 5, 7, 12, 15, 53.77443751081734, 4.8999999999999995, 263.49474380300495, 14.63859687794472, 0.01792481250360578
test/swagger.js, test, pascalCase, 245, 3, 1, 1, 1, 1, 4, 5, 4, 5, 8, 10, 30, 2.5, 75, 4.166666666666667, 0.01
test/swagger.js, test, pascalCaseFilename, 250, 3, 1, 1, 1, 1, 6, 7, 6, 7, 12, 14, 50.18947501009619, 3.5, 175.66316253533665, 9.75906458529648, 0.016729825003365395
test/swagger.js, test, propChecker, 259, 28, 3, 5, 3, 1, 12, 33, 11, 23, 23, 56, 253.31946953919274, 12.545454545454545, 3178.0078905826, 176.55599392125555, 0.08443982317973091
test/swagger.js, test, anonymous, 265, 17, 8, 2, 4, 0.5, 15, 34, 12, 24, 27, 58, 275.7834751254812, 15, 4136.752126882217, 229.81956260456764, 0.09192782504182706
test/swagger.js, test, validateMaximum, 288, 5, 2, 2, 2, 1, 6, 7, 17, 33, 23, 40, 180.94247824228052, 5.823529411764706, 1053.723843881516, 58.54021354897311, 0.0603141594140935
test/swagger.js, test, validateMinimum, 294, 5, 2, 2, 2, 1, 6, 7, 19, 36, 25, 43, 199.68581616031315, 5.684210526315789, 1135.0562181744115, 63.0586787874673, 0.06656193872010438
test/swagger.js, test, validateNumber, 300, 5, 2, 1, 2, 1, 7, 8, 4, 5, 11, 13, 44.97261104228487, 4.375, 196.7551733099963, 10.930842961666462, 0.01499087034742829
test/swagger.js, test, validateInteger, 306, 5, 2, 1, 2, 1, 7, 8, 4, 5, 11, 13, 44.97261104228487, 4.375, 196.7551733099963, 10.930842961666462, 0.01499087034742829
test/swagger.js, test, validateFile, 312, 5, 2, 1, 2, 1, 9, 10, 4, 6, 13, 16, 59.207035490257475, 6.75, 399.64748955923795, 22.202638308846552, 0.019735678496752493
test/swagger.js, test, validateBoolean, 318, 5, 2, 1, 5, 2.5, 8, 18, 6, 10, 14, 28, 106.60593781761291, 6.666666666666667, 710.7062521174195, 39.48368067318997, 0.03553531260587097
test/swagger.js, test, validateString, 324, 5, 2, 1, 2, 1, 7, 9, 3, 5, 10, 14, 46.50699332842307, 5.833333333333334, 271.29079441580126, 15.071710800877847, 0.015502331109474358
test/swagger.js, test, validateDateTime, 330, 5, 2, 1, 2, 1, 6, 8, 5, 6, 11, 14, 48.432042660922164, 3.5999999999999996, 174.35535357931977, 9.686408532184432, 0.01614401422030739
test/swagger.js, test, validateGuid, 336, 10, 3, 1, 2, 0.6666666666666666, 8, 13, 6, 9, 14, 22, 83.76180828526729, 6, 502.5708497116037, 27.920602761755763, 0.027920602761755765
test/swagger.js, test, validateMaxLength, 347, 7, 2, 2, 3, 1.5, 10, 12, 25, 55, 35, 67, 343.66196213531276, 11, 3780.2815834884404, 210.01564352713558, 0.11455398737843758
test/swagger.js, test, validateUniqueItems, 355, 26, 11, 3, 6, 0.5454545454545454, 16, 49, 21, 34, 37, 83, 432.38462934720286, 12.952380952380953, 5600.410437259008, 311.133913181056, 0.14412820978240096
test/swagger.js, test, anonymous, 365, 8, 2, 3, 3, 1.5, 11, 22, 11, 19, 22, 41, 182.83669636412918, 9.5, 1736.9486154592273, 96.49714530329041, 0.06094556545470973
test/swagger.js, test, validateMinItems, 382, 5, 2, 2, 4, 2, 15, 19, 24, 53, 39, 72, 380.5489597580819, 16.5625, 6302.8421459932315, 350.157896999624, 0.12684965325269396
test/swagger.js, test, validateMaxItems, 388, 5, 2, 2, 3, 1.5, 11, 13, 24, 55, 35, 68, 348.7912451522577, 12.604166666666666, 4396.222985773248, 244.234610320736, 0.1162637483840859
test/swagger.js, test, validateMinLength, 394, 5, 2, 2, 3, 1.5, 10, 12, 22, 49, 32, 61, 305, 11.136363636363635, 3396.5909090909086, 188.69949494949492, 0.10166666666666667
test/swagger.js, test, validatePattern, 400, 6, 3, 2, 2, 0.6666666666666666, 12, 14, 6, 10, 18, 24, 100.07820003461549, 10, 1000.782000346155, 55.59900001923083, 0.0333594000115385
test/swagger.js, test, validateValueBySchema, 407, 221, 132, 6, 57, 0.4318181818181818, 24, 478, 108, 378, 132, 856, 6030.001366170836, 42, 253260.05737917512, 14070.00318773195, 2.0100004553902786
test/swagger.js, test, anonymous, 515, 5, 2, 1, 2, 1, 9, 13, 8, 10, 17, 23, 94.0116453487578, 5.625, 528.8155050867626, 29.378639171486814, 0.0313372151162526
test/swagger.js, test, anonymous, 522, 10, 2, 3, 1, 0.5, 10, 21, 13, 18, 23, 39, 176.41891628622352, 6.923076923076923, 1221.3617281353936, 67.8534293408552, 0.05880630542874117
test/swagger.js, test, anonymous, 609, 10, 2, 3, 1, 0.5, 9, 23, 16, 20, 25, 43, 199.68581616031315, 5.625, 1123.2327159017614, 62.40181755009785, 0.06656193872010438
test/swagger.js, test, validateParam, 630, 20, 3, 3, 1, 0.3333333333333333, 9, 28, 13, 22, 22, 50, 222.97158093186488, 7.615384615384615, 1698.0143470965093, 94.33413039425051, 0.07432386031062163
test/swagger.js, test, parseSearch, 651, 4, 2, 0, 1, 0.5, 8, 11, 7, 8, 15, 19, 74.23092131656186, 4.571428571428571, 339.3413545899971, 18.85229747722206, 0.024743640438853954
test/swagger.js, test, serializeSearch, 656, 4, 2, 1, 1, 0.5, 8, 10, 6, 8, 14, 18, 68.53238859703687, 5.333333333333333, 365.50607251752996, 20.305892917640552, 0.022844129532345624
test/swagger.js, test, btoa, 661, 11, 6, 1, 2, 0.3333333333333333, 11, 18, 6, 14, 17, 32, 130.79881092001085, 12.833333333333334, 1678.5847401401393, 93.2547077855633, 0.04359960364000362
test/swagger.js, test, buildFormData, 683, 13, 6, 1, 3, 0.5, 14, 33, 14, 25, 28, 58, 278.826585479341, 12.5, 3485.3323184917626, 193.62957324954237, 0.09294219515978033
test/swagger.js, test, shallowEqualKeys, 698, 5, 1, 3, 1, 1, 6, 9, 4, 5, 10, 14, 46.50699332842307, 3.75, 174.40122498158652, 9.688956943421474, 0.015502331109474358
test/swagger.js, test, anonymous, 699, 3, 1, 1, 1, 1, 6, 7, 4, 6, 10, 13, 43.18506523353571, 4.5, 194.3327935509107, 10.796266308383927, 0.014395021744511903
test/swagger.js, test, requiresValidationURL, 704, 11, 3, 1, 5, 1.6666666666666667, 10, 18, 9, 15, 19, 33, 140.1816079436383, 8.333333333333334, 1168.180066196986, 64.89889256649923, 0.04672720264787944
test/swagger.js, test, getAcceptControllingResponse, 716, 28, 9, 1, 7, 0.7777777777777778, 12, 44, 18, 34, 30, 78, 382.73746645746445, 11.333333333333332, 4337.69128651793, 240.9828492509961, 0.1275791554858215
test/swagger.js, test, suitable2xxResponse, 727, 3, 1, 2, 2, 2, 9, 15, 10, 12, 19, 27, 114.6940428629768, 5.3999999999999995, 619.3478314600746, 34.40821285889304, 0.03823134762099227
test/swagger.js, test, getExtensions, 754, 7, 4, 4, 2, 0.5, 9, 23, 12, 21, 21, 44, 193.26196660226546, 7.875, 1521.9379869928405, 84.55211038849114, 0.06442065553408849
test/swagger.js, test, deeplyStripKey, 770, 22, 5, 3, 5, 1, 15, 31, 14, 23, 29, 54, 262.3309737368889, 12.321428571428571, 3232.292354972381, 179.5717974984656, 0.0874436579122963
test/swagger.js, test, anonymous, 782, 7, 4, 1, 2, 0.5, 11, 19, 5, 16, 16, 35, 140, 17.6, 2464, 136.88888888888889, 0.04666666666666667
test/swagger.js, test, stringify, 793, 23, 11, 1, 7, 0.6363636363636364, 15, 45, 13, 30, 28, 75, 360.5516191543203, 17.307692307692307, 6240.316485363235, 346.6842491868464, 0.1201838730514401
test/swagger.js, test, numberToString, 817, 7, 3, 1, 2, 0.6666666666666666, 8, 11, 4, 7, 12, 18, 64.5293250129808, 7, 451.70527509086565, 25.09473750504809, 0.021509775004326936
test/swagger.js, test, paramToIdentifier, 825, 32, 11, 2, 6, 0.5454545454545454, 18, 52, 29, 69, 47, 121, 672.1052510529942, 21.413793103448278, 14392.32278978998, 799.5734883216655, 0.2240350836843314
test/swagger.js, test, paramToValue, 858, 13, 3, 3, 1, 0.3333333333333333, 12, 20, 13, 17, 25, 37, 171.8226790216648, 7.846153846153847, 1348.1471738622931, 74.89706521457184, 0.057274226340554936
test/swagger.js, test, values, 864, 3, 1, 1, 1, 1, 4, 4, 2, 3, 6, 7, 18.094737505048094, 3, 54.28421251514428, 3.0157895841746822, 0.006031579168349364
test/swagger.js, test, generateCodeVerifier, 873, 3, 1, 0, 1, 1, 5, 7, 6, 6, 11, 13, 44.97261104228487, 2.5, 112.43152760571218, 6.246195978095121, 0.01499087034742829
test/swagger.js, test, createCodeChallenge, 877, 5, 1, 1, 1, 1, 5, 9, 8, 9, 13, 18, 66.60791492653966, 2.8125, 187.3347607308928, 10.407486707271822, 0.022202638308846556
test/swagger.js, test, b64toB64UrlEncoded, 883, 3, 1, 1, 1, 1, 6, 12, 9, 12, 15, 24, 93.76537429460444, 4, 375.06149717841777, 20.836749843245432, 0.03125512476486815
test/swagger.js, test, isEmptyValue, 887, 11, 5, 1, 3, 0.6, 8, 14, 5, 9, 13, 23, 85.11011351724513, 7.2, 612.792817324165, 34.04404540689805, 0.028370037839081708
